5 5
0 0
4 4
2 7 3 2 6 
0 1 4 8 8 
6 6 8 0 9 
1 7 8 9 2 
8 5 6 0 0 
