10 10
0 0
9 9
1 6 3 2 3 6 2 3 5 9 
4 8 4 4 1 9 2 1 7 9 
0 1 9 7 2 8 9 1 7 6 
2 7 9 9 6 5 6 7 9 6 
7 8 4 2 0 4 0 3 3 1 
7 5 1 5 6 6 4 6 6 8 
4 6 6 3 3 5 6 5 9 9 
7 5 3 6 9 2 9 6 1 3 
6 7 6 9 7 8 2 3 0 6 
0 1 8 9 0 1 5 6 3 1 
