15 15
0 0
14 14
2 6 8 2 6 2 4 3 0 2 7 9 6 0 2 
4 9 8 0 8 5 4 2 7 1 3 6 1 1 7 
2 1 8 0 2 7 9 0 5 2 1 3 9 6 1 
9 0 5 8 5 6 0 8 0 3 6 9 3 5 7 
9 0 6 8 5 7 7 2 9 8 7 1 1 4 7 
7 7 4 2 9 0 2 3 8 7 9 3 1 2 6 
7 3 6 8 2 5 9 3 0 9 7 7 6 9 7 
9 3 3 2 4 1 3 1 0 3 7 8 0 9 4 
1 1 8 6 7 4 0 1 6 5 3 6 1 9 0 
6 3 5 8 5 5 8 6 8 9 2 2 9 4 9 
5 4 2 9 7 9 4 0 4 5 3 0 2 9 5 
9 7 0 7 0 6 8 0 1 6 2 3 4 7 4 
1 0 6 6 8 5 1 3 9 0 0 2 3 1 3 
4 4 4 7 0 3 4 8 4 7 6 4 3 9 0 
4 9 9 8 8 9 3 0 4 7 0 9 6 0 5 
