20 20
0 0
19 19
0 1 4 7 5 8 3 3 0 7 4 5 4 1 6 2 5 4 7 9 
7 1 0 1 1 1 1 1 5 8 6 9 4 4 6 3 0 0 3 3 
7 0 2 4 6 5 7 2 5 3 4 5 5 7 2 8 1 3 1 2 
3 0 1 8 1 5 6 0 0 6 5 5 9 2 6 6 5 1 6 9 
0 7 9 3 8 4 7 8 8 4 7 9 0 5 2 9 0 1 3 5 
0 1 8 3 7 0 8 4 7 6 6 1 0 6 8 9 8 1 2 1 
7 7 4 8 0 7 1 6 5 7 4 1 1 5 5 0 9 2 4 9 
7 1 7 5 2 2 4 4 2 9 9 5 1 0 7 6 9 8 9 6 
3 0 1 4 7 8 0 5 0 3 2 7 8 2 8 9 1 9 6 5 
8 1 1 8 4 0 3 9 9 0 9 0 5 1 7 3 1 3 3 8 
7 5 2 7 8 7 7 4 1 8 8 0 9 9 9 4 5 9 2 7 
3 0 2 0 4 5 0 3 6 4 1 0 4 7 6 1 9 2 6 9 
1 8 8 9 4 4 6 2 6 5 9 1 7 6 1 4 3 1 1 1 
3 7 8 0 4 0 5 1 7 4 6 9 5 4 9 3 7 4 7 5 
6 2 1 8 3 0 3 7 6 9 6 8 1 9 0 7 0 5 1 8 
3 4 3 8 1 8 3 4 5 1 3 0 3 6 9 4 9 0 9 2 
2 0 9 2 4 7 9 4 8 8 1 6 3 6 8 5 9 4 5 9 
6 0 9 7 0 3 6 2 2 6 5 0 4 5 8 0 2 6 6 6 
7 8 8 0 6 0 6 8 6 3 1 5 2 9 8 8 9 3 2 9 
2 7 5 7 7 3 9 5 7 2 7 4 9 5 7 0 9 3 1 6 
